BD15153D13
C3C7ABC56A
BC552C1556
813FAFAFFF
AAAFEF857F
AAEFFFAFFF
AA953FAFFF
AC696FAFFF
A93C53C53B
C6C57C5546

0,0
9,9SESEEENNEESEENESSWWWSSSSSSEESE